####################
#L.................#
#..................#
#......######......#
#..................#
#..........#.......#
#..........#.......#
#..1.......#....2..#
#..........#.......#
#..........#.......#
#..................#
#......######......#
#..................#
#.................U#
####################
